#############################
#....###############...#...##
#.##.................#.#.#..#
s.####################...##.#
##########################..#
#..........................##
#.###########################
#...........................f
#############################
